SO              ./path_so
NO                  ./path_no
EA            ./path_ea
WE                                       ./path_we

F 220,100,0
C 100,50,5

  111111111111111
110000000000000001111
11100000000111111
100000111111
100000111
1111111