SO              ./path_so
NO                  ./path_no
EA            ./path_ea
WE                                       ./path_we

F 220,100,0
C 100,50,5

11111111111111
110000001111111
10000000000000000001
1000000000000111111
1000000000000111
11111111111111