
SO ./path_so.xpm
NO ./path_no.xpm
EA ./path_ea.xpm
WE ./path_we.xpm

F 220,100,0
C 100,50,5

111111111111111111
100000000000000001
100N00100000100001
100000000000000001
100000000010000001
100000000000000001
100000000000000001
111111111111111111


