



SO ./path_so
NO ./path_no
EA ./path_ea
WE ./path_we

F 220,100,0
C 100,50,5

111111111111111111
100000000000000001
100000100000100001
100000000000000001
100000000010000001
111111100011111111
100000000N00000001
111111111111111111


