



SO ./path_so
NO ./path_no
EA ./path_ea
WE ./path_we

F 220,100,0
C 100,50,5

  1111111111111111111111
11000000000000000001111
111000E00001111111
1100000000000111111
10000011111111
1111111




